
                                 111111
                                111111
                               111111
                             111111
                           111111
                         1111111

1111111111111111111111111111111111111111111111111111111111111111
1111111111111111111111111111111111111111111111111111111111111111